21 26
00000000111111111111111111
00000000122222222222222221
00000000122222222222222221
00000000122222222222222221
00000000122222222222222221
00000000111111111222222221
11111111111111111222222221
12222222211111111222222221
12222222211111111222222221
12222222222222222222222221
12222222222222222222222221
12222222222222222222222221
12222222222222222222222221
12222222211111112222222221
12222222211111112222222221
11111111111111112222222221
00000000122222222222222221
00000000122222222222222221
00000000122222222222222221
00000000122222222222222221
00000000111111111111111111
